24
32
0 0 0 0 0 0 0 0 0 0 0 0 0 0 0 0 = 0 0 0 0 0 0 0 0 0 0 0 0 0 0 0 
0 0 0 0 0 0 0 0 0 0 0 0 0 0 0 0 0 0 0 0 0 0 0 0 0 0 = = 0 0 0 0 
0 0 0 0 = = = = = 0 0 0 0 0 0 0 0 0 0 0 0 0 0 0 0 0 0 0 0 0 0 0 
0 0 0 0 0 0 0 0 0 0 0 0 0 0 0 0 0 0 0 0 0 0 0 0 0 0 0 0 0 0 = = 
0 0 0 0 0 0 0 0 0 0 0 0 = = = = = = = = 0 0 0 0 0 0 0 0 0 0 0 0 
0 0 0 0 0 0 0 0 0 0 0 0 0 0 0 0 0 0 0 0 0 0 0 0 0 0 0 0 0 0 0 0 
0 0 0 0 0 0 0 0 0 0 0 0 0 0 0 0 0 0 0 0 0 0 0 0 0 0 0 0 0 0 0 0 
0 0 0 0 0 0 0 0 0 0 0 0 0 0 0 = 0 0 = 0 0 = = = = = = = = = = = 
= 0 0 0 0 0 0 0 0 0 0 0 0 0 0 = 0 0 0 0 0 0 0 0 0 0 0 0 0 0 0 = 
0 0 0 0 0 0 0 0 0 0 0 0 0 0 0 = = 0 0 0 0 0 0 0 0 0 0 0 0 0 0 = 
0 0 0 0 0 0 0 0 0 0 0 0 0 0 0 = = = = = = = = = = = = = = 0 0 0 
0 0 0 0 0 0 0 0 0 0 0 0 0 0 0 = = = 0 0 0 0 0 0 0 0 0 0 0 0 0 0 
0 0 0 0 0 0 0 0 0 0 0 0 0 0 0 = = 0 0 0 0 0 0 0 0 0 0 0 0 0 0 0 
0 0 0 0 0 0 0 0 0 0 0 0 0 0 0 0 0 0 0 0 0 0 0 0 0 0 0 0 0 0 0 0 
0 0 0 0 0 0 0 0 0 0 0 0 0 0 0 0 0 0 0 0 0 0 0 0 0 0 0 0 0 0 0 0 
0 0 0 = = = = 0 0 0 0 0 0 0 0 0 0 0 0 0 0 0 = = = 0 0 0 0 0 0 0 
0 0 0 = 0 0 0 0 0 0 0 0 0 0 0 0 0 0 0 0 0 0 0 0 0 0 0 0 0 0 = = 
0 0 0 = 0 0 0 0 0 0 0 0 0 0 0 0 0 0 0 0 = = = = = 0 0 0 0 0 = = 
0 0 0 = = = = 0 0 0 0 0 0 0 0 0 0 0 0 0 0 0 0 0 0 0 0 0 0 0 0 0 
0 0 0 0 0 0 0 0 0 0 0 0 0 0 0 0 0 0 0 0 0 0 0 0 0 0 0 0 0 0 0 0 
0 0 0 0 0 0 0 0 0 0 0 = 0 0 0 0 0 0 0 0 0 0 0 0 0 0 0 = = 0 0 0 
0 0 0 0 0 0 0 0 0 0 = = 0 0 0 0 0 0 0 0 0 0 0 0 0 0 0 = = 0 0 0 
0 0 0 0 0 0 0 0 0 0 0 0 0 0 0 0 0 0 0 = = 0 0 0 0 0 0 0 0 0 0 0 
0 0 0 0 0 0 0 0 0 0 0 0 0 0 0 0 0 0 0 = = 0 0 0 0 0 0 0 0 0 0 0 
